######################
###   #########   ####
######################
######        ########
######        ########
######        ########
######        ########
######        ########
######        ########
######        ########
######        ########
######        ########
